R 1920 1080
NO ./bmp/test.bmp
SO ./bmp/test.bmp
WE ./bmp/test.bmp
EA ./bmp/test.bmp

S ./bmp/test.bmp
F 128,32,16
C 16,32,64

N       1111111111111111111111111
        1         11            1
        1 11     111      2     1
        1  1                    1
111111111 11     111            1
1         11     111 111111111111
1111 111111111 111      1   1
1111 111111111 111 1 1  1   1
11      11 1 1 111      1   1
1   2           11      1   1
1               11 1 1  1   1
11     111 1 1 11111 1111   111
1111 111 111 1 1 1 1111 1   1
11111111 1111111 111111111111